111111111
1C0000001
10111C001
1000P0001
1C0111001
100000C01
100000E01
111111111
