11111111111111111111111111111111111
10C000000000000001000000000000000E1
100000C0000000000100000000000000001
1000000000000000010000000C000000001
1P00000000000C000100000000000000001
11111111111111111111111111111111111
